5 5 5 5 5 0 0 0 0 0 0 0 0 0 0 0
5 4 4 4 5 0 1 0 0 0 0 0 1 0 0 0
5 4 4 4 5 0 0 0 0 0 0 0 0 0 0 0
5 5 4 5 5 0 0 0 7 0 0 0 0 0 0 0
5 0 0 0 0 0 0 0 0 0 0 0 0 0 0 0
5 0 0 0 0 6 0 0 0 0 0 0 7 0 0 0
5 0 0 0 0 0 0 0 2 0 0 0 0 0 0 0
5 0 0 0 1 0 0 0 0 0 0 0 0 0 0 0
5 0 0 0 0 0 0 0 6 0 0 0 0 0 0 0
5 0 0 2 0 0 0 0 0 0 0 0 0 0 0 0
5 0 0 0 0 0 0 0 0 0 6 0 0 2 0 0
5 0 0 0 0 0 0 0 0 0 0 0 0 0 0 0